111111
1P0E11
110011
1C1111
11111
