11111111111111111
11111111111111111

11111111111111111
11111111111111111
11111111111111111

11E11111111111111
11C11111111111111
11111111111111111
11111111111111111
11111111111111111
1P111111111111111
11111111111111111
