11111111111111
10010000000C11
10000111110011
100P11E0000011
11111111111111