1111111111111111111111
1000000000E000P00000C1
1111111111111111111111
