1111111111
1P000010C1
1011101011
1C00000001
1110101111
10000C0001
1000111001
1E00000001
1111111111
