111111111111111111111111111111111111111111111111111111111111111111111
10000000000000C00000C000000000001111111111111111111111111111111111111
101001010010000010100100000001010111111111111111111111111111111111111
101001001010101000100100000001010111111111111111111111111111111111111
10000000C00C0000000000000000000C1111111111111111111111111111111111111
111111111111111111111111111011111111111111111111111111111111111111111
10000000000000C00000C000000000001111111111111111111111111111111111111
10100101001000E010100100000001010111111111111111111111111111111111111
101001001010101000100100000001010111111111111111111111111111111111111
10000000C00C0000000000000000000C1111111111111111111111111111111111111
111111111111111111111110111111111111111111111111111111111111111111111
101001010010000010100100000001010111111111111111111111111111111111111
101001001010101000100100000001010111111111111111111111111111111111111
10000000C00C0000000000000000000C1111111111111111111111111111111111111
111111111111111111111111110111111111111111111111111111111111111111111
10000000000000C00000C000000000001111111111111111111111111111111111111
101001010010000010100100000001010111111111111111111111111111111111111
101001001010101000100100000001010111111111111111111111111111111111111
10000000C00C0000000000000000000C1111111111111111111111111111111111111
111111111111111111111111110111111111111111111111111111111111111111111
10000000000000C00000C000000000001111111111111111111111111111111111111
101001010010000010100100000001010111111111111111111111111111111111111
101001001010101000100100000001010111111111111111111111111111111111111
1P0000000C00C0000000000000000000C111111111111111111111111111111111111
111111111111111111111111111111111111111111111111111111111111111111111