1111111
1C000C1
1000001
100E001
1000001
1C000P1
1111111
