111111111111111111111
10000000000000C000001
101001010010000010101
101001001001010001010
1P0000000C00C000000E1
111111111111111111111
